111111111111111
100000000000001
101111111000001
101000001000001
101011101000001
10100C101000001
101111101000001
100000001P000E1
111111111111111