1111111111111
100C000000001
1000011111001
1P000110000E1
1111111111111