1111111111111
100C000000001
1000011111001
1P00011E00001
1111111111111