1111111111111111111111111111111111111111
1000000000000000000000000000000000P00001
1000C00C000CCCCC0000C0000000000000000001
1000C00C000C000C00000000000000C0C0000001
1000CCCC000C000C0000C0000000000000000001
1000C00C000C000C0000C0000000C00000C00001
1E10C00C000CCCCC0000C00000000CCCCC000001
1010000000000000000000000000000000000001
1111111111111111111111111111111111111111